024 024 003 047 047 047 004 024 024 024
024 024 025 299 001 002 023 024 024 024
024 024 025 023 024 025 023 024 024 024
003 047 048 023 024 025 023 024 024 024
025 299 001 027 024 025 046 047 047 047
025 023 024 024 024 026 001 001 001 001
025 023 024 024 024 024 024 024 024 024
